CKG|江北国际机场|重庆|CKG
TVS|唐山三女河机场|唐山|TVS
TCZ|腾冲机场|腾冲|TCZ
LLF|零陵机场|永州|llf
AQG|安庆(天柱山）机场|安庆|AQG
BSD|保山云瑞机场|保山|BSD
HSN|普陀山机场|舟山|HSN
HLH|乌兰浩特机场|乌兰浩特|HLH
DYG|荷花机场|张家界|DYG
HET|白塔国际机场|呼和浩特|HET
FUG|阜阳西关机场|阜阳|FUG
ZGC|中川机场|兰州|LHW
TAO|流亭国际机场|青岛|TAO
KHN|昌北国际机场|南昌|KHN
LYG|白塔埠机场|连云港|LYG
AVA|黄果树机场|安顺|AVA
ACX|兴义机场|兴义|ACX
XUZ|观音国际机场|徐州|XUZ
LUM|芒市机场|芒市|LUM
YIN|伊宁机场|伊宁|YIN
URC|地窝堡国际机场|乌鲁木齐|URC
KGT|康定机场|康定|KGT
ZYI|遵义新舟机场|遵义|ZYI
YTY|扬州泰州机场|扬州|yty
INC|河东机场|银川|INC
LZH|白莲机场|柳州|LZH
WNZ|温州龙湾国际机场|温州|WNZ
DLC|周水子国际机场|大连|DLC
KHG|喀什机场|喀什|KHG
JDZ|景德镇罗家机场|景德镇|JDZ
NGB|栎社国际机场|宁波|NGB
JMU|佳木斯机场|佳木斯|JMU
YNT|莱山机场|烟台|YNT
KWE|龙洞堡国际机场|贵阳|KWE
CIF|赤峰玉龙机场|赤峰|CIF
BPL|新疆博乐机场|博乐|bpl
IQN|庆阳机场|庆阳|IQN
JZH|黄龙机场|九寨沟|jzh
NKG|南京禄口国际机场|南京|NKG
NTG|南通兴东机场|南通|NTG
MDG|牡丹江海浪机场|牡丹江|MDG
DAX|达州(河市)机场|达州|dax
HYN|路桥国际机场|台州|hyn
WNH|云南文山普者黑机场|文山|wnh
NAO|南充高坪机场|南充|NAO
KWL|两江国际机场|桂林|KWL
JNZ|锦州小岭子机场|锦州|JNZ
NDG|齐齐哈尔三家子机场|齐齐哈尔|NDG
NZH|呼伦贝尔满洲里西郊机场|满洲里|nzh
TSN|滨海国际机场|天津|TSN
ERL|二连浩特赛乌苏国际机场|二连浩特|erl
HLD|东山国际机场|海拉尔|HLD
GYU|六盘山机场|固原|gyu
SHP|秦皇岛山海关机场|秦皇岛|SHP
TXN|屯溪机场|黄山|TXN
LLB|荔波机场|黔南州|LLB
JHG|西双版纳机场|西双版纳|jhg
NBS|长白山机场|长白山|nbs
MXZ|梅县机场|梅县|MXZ
XFN|刘集机场|襄阳|xfn
KRY|克拉玛依机场|克拉玛依|KRY
HDG|河北邯郸机场机场|邯郸|hdg
AEB|广西百色(田阳)机场|百色|aeb
CIH|王村机场|长治|CIH
HGH|萧山国际机场|杭州|HGH
CHG|辽宁朝阳机场|朝阳|CHG
XIL|锡林浩特机场|锡林浩特|XIL
WUA|乌海机场|乌海|wua
ZAT|昭通机场|昭通|ZAT
DDG|丹东浪头机场|丹东|DDG
YIH|三峡机场|宜昌|YIH
YCU|运城关公机场|运城|ycu
HIA|淮安涟水机场|淮安|hia
NNG|吴圩国际机场|南宁|NNG
DQA|萨尔图机场|大庆|dqa
ZHY|中卫(香山、沙坡头)机场|中卫|zhy
HJJ|怀化芷江机场|怀化|hjj
DOY|东营胜利机场|东营|doy
JNG|济宁机场|济宁|JNG
LCX|福建龙岩冠豸山机场|龙岩|lcx
WUH|天河国际机场|武汉|wuh
JUZ|衢州机场|衢州|JUZ
SJW|正定国际机场|石家庄|SJW
JIU|九江庐山机场|九江|JIU
WUZ|广西梧州长洲岛机场|梧州|WUZ
SWA|揭阳潮汕机场|揭阳|swa
NAY|南苑机场|北京|BJS
PEK|首都国际机场|北京|bjs
JGN|嘉峪关机场|嘉峪关|JGN
DLU|大理荒草坝机场|大理|DLU
RKZ|日喀则和平机场|日喀则|rkz
KMG|昆明长水国际机场|昆明|KMG
GOQ|格尔木机场|格尔木|GOQ
WXN|重庆万州五桥机场|万州|wxn
RLK|巴彦淖尔天吉泰机场|巴彦淖尔|rlk
NLT|那拉提机场|那拉提|nlt
SZX|宝安国际机场|深圳|SZX
FUO|佛山沙堤机场|佛山|fuo
MIG|南郊机场|绵阳|MIG
OHE|漠河古莲机场|漠河|ohe
DNH|敦煌机场|敦煌|DNH
HMI|哈密机场|哈密|HMI
NNY|南阳姜营机场|南阳|NNY
CGO|新郑国际机场|郑州|CGO
FOC|长乐国际机场|福州|FOC
CSX|黄花国际机场|长沙|CSX
YIE|阿尔山伊尔施机场|阿尔山|yie
SYM|普洱(思茅)机场|普洱|sym
JGD|加格达奇机场|加格达奇|jgd
SHE|桃仙国际机场|沈阳|SHE
BPX|西藏昌都邦达机场|昌都|bpx
KRL|库尔勒机场|库尔勒|KRL
ZHA|湛江机场|湛江|ZHA
XIC|西昌青山机场|西昌|XIC
AKU|阿克苏机场|阿克苏|AKU
CGQ|龙嘉国际机场|长春|CGQ
YIW|义乌机场|义乌|YIW
WEH|大水泊国际机场|威海|WEH
HZG|汉中西关机场|汉中|HZG
WUS|武夷山机场|武夷山|WUS
LDS|伊春林都机场|伊春|lds
AOG|鞍山腾鳌机场|鞍山|AOG
ENH|恩施机场|恩施|ENH
XMN|高崎国际机场|厦门|XMN
GYS|广元机场|广元|gys
DAT|大同云冈机场|大同|DAT
SYX|三亚凤凰机场|三亚|SYX
HFE|合肥新桥国际机场|合肥|HFE
UYN|榆林榆阳机场|榆林|UYN
YNZ|江苏盐城南洋机场|盐城|ynz
YBP|宜宾(菜坝)机场|宜宾|YBP
BHY|福城机场|北海|BHY
HTN|和田机场|和田|HTN
LJG|丽江三义国际机场|丽江|LJG
BAV|二里半机场|包头|BAV
HRB|太平国际机场|哈尔滨|HRB
CTU|双流国际机场|成都|CTU
JGS|井冈山机场|井冈山|jgs
TYN|武宿国际机场|太原|TYN
KCA|库车机场|库车|KCA
TCG|塔城民航机场|塔城|TCG
ZUH|珠海金湾机场|珠海|ZUH
YUS|青海玉树三江源(巴塘)机场|玉树|yus
LZO|泸州蓝田机场|泸州|LZO
JJN|泉州晋江机场|晋江|JJN
LYI|临沂沭埠岭机场|临沂|LYI
CGD|常德桃花源(斗姆湖)机场|常德|CGD
NGQ|阿里昆莎机场|阿里|ngq
WUX|苏南硕放国际机场|无锡|wux
AAT|阿勒泰机场|阿勒泰|AAT
LNJ|临沧机场|临沧|lnj
CAN|新白云国际机场|广州|CAN
LXA|贡嘎国际机场|拉萨|LXA
TLQ|吐鲁番交河机场|吐鲁番|tlq
ENY|延安二十里铺机场|延安|ENY
HAK|美兰国际机场|海口|HAK
HZH|贵州黎平机场|黎平|hzh
KOW|黄金机场|赣州|KOWjzh
PVG|浦东国际机场|上海|sha
SHA|虹桥国际机场|上海|SHA
JIQ|黔江武陵山机场|黔江|jiq
KJI|新疆喀纳斯机场|喀纳斯|kji
DSN|伊金霍洛机场|鄂尔多斯|dsn
XIY|咸阳国际机场|西安|sia
WEF|潍坊机场|潍坊|WEF
CZX|奔牛国际机场|常州|CZX
LYA|洛阳机场|洛阳|LYA
HEK|黑河机场|黑河|HEK
DIG|香格里拉机场|迪庆|dig
TGO|通辽机场|通辽|TGO
JXA|鸡西兴凯湖机场|鸡西|jxa
XNN|曹家堡机场|西宁|XNN
TNA|遥墙国际机场|济南|TNA
YNJ|朝阳川国际机场|延吉|YNJ
